##################################
#................................#
#................................#
#................................#
#...............E................#
#................................#
#................................#
#.......P........................#
#................................#
##################################