########||||||||||########
#......############......#
#......############......#
#........................#
#......############......#
#......############......#
########||||||||||########