##################################
#................................#
#................................#
#................................#
#...............E................#
#................................#
#................................#
#.......P..........P.............#
#...............................S#
##################################