##################################
#................................#
#............P...........S.......#
#......S.........................#
#...............E................#
#..P........E.............E......#
#................................#
#.......P..........P.............#
#...E.........S.................S#
##################################