#######################################
#.....................................#
#########.............................#
#####################################.#
#####################################.#
#####################################.#
#####################################.#
#####################################.#
###########################...........#
#########################.............######
#####################################......#
##########################################.#
##########################################.#
#########################################..#
~~~~~~~~~~~~~~~~~~~~~~~~~~~~~~~~~~~~~~~~#.##
~~~~~~~~~~~~~~~~~~~~~~~~~~~~~~~~~~~~~~~~#.#
~~~~~~~~~~~~~~~~~~~~~~~~~~~~~~~~~~~~~~~#..#
~~~~~~~~~~~~~~~~~~~~~~~~~~~~~~~~~~~~~##..##
~~~~~~~~~~~~~~~~~~~~~~~~~~~~~~~~~~~~##..###
~~~~~~~~~~~~~~~~~~~~~~~~~~~~~~~~~~~##..####
###################################.......#
##################################........#
##################################........#
##################################........#
##################################........#
